00000000000000000000000000
00000000000000000000000000
01111111111111111111111111
01002222222222222222222001
01022202222200222222022201
01222222222222222222222221
01222222202222220222222221
01222222222222222222222221
01222022222222222222202221
01222222222200222222222221
01222222222200222222222221
01222022222222222222202221
01222222202222220222222221
01222222222222222222222221
01222022222200222222202221
01022222222222222222222201
01002222222222222222222001
01111111111111111111111111